

F 230,100,0
C 225,30,0


WE ./textures/wall_w.xpm

SO ./textures/wall_s.xpm

EA ./textures/wall_e.xpm


NO ./textures/wall_n.xpm

     111
1111111111111111111111111111
110000011N00000000110111100011
11111111110111111111111111111111
111110111100111111
1111111111111
111111
111100111
111111
