11111111111111
10010111000011
10101000000001
1100N000000001
11000000011001
11111000011111
11111111111111
